ID=ID
NAME=姓名
IDCART=身份证号
GENDER=性别
BIRTHDAY=出生日期
NATION=民族
BELIEF=宗教信仰
MARITALSTATUS=婚姻状况
SOCIALSECURITYCARD=社保卡号
CULTUREDEGREE=文化程度
LIVINGADDRESS=居住地址
LIVINGCONDITION=居住情况
ECONOMICSOURCE=经济来源
PAYMENTTYPE=医疗费用支付方式
ASSESSMENTREASON=评估原因
LEVELDAILYLIVING=日程生活能力
LEVELMENTALITY=精神状态
LEVELPERCEPTION=感知觉与沟通
LEVELSOCIALPARTIPATION=社会参与等级
PRIMARYLEVEL=老人能力初步等级
FINALLEVEL=老人能力最终等级
CREATETIME=创建时间
UPDATETIME=修改时间
PROVIDERNAME=信息提供者姓名    
PROVIDERRELATION=提供者与老人关系
LINKMAN1NAME=第一联系人姓名    
LINKMAN1PHONE=第一联系人手机   
LINKMAN2NAME=第二联系人姓名    
LINKMAN2PHONE=第二联系人手机   
LINKMAN3NAME=第三联系人姓名    
LINKMAN3PHONE=第三联系人手机   
EVALUATENAME=评估人姓名    
EVALUATEPHONE=评估人电话   
EVALUATEGROUP=评估人机构   
EVALUATEADDRESS=评估人居住地址 
EVALUATEEMAIL=评估人邮箱